11111111111111111111111
00000000000000000000000
00000000000000000000000
00001001111111111111111
00001000000000000000000
10001000000000000000000
10001000000000000000000
11111111100000111110010
10000100000000000010010
10000100000420000010010
10000100000010000010010
10000100000011111110010
10000000000010000010010
10000000000010010010010
10000000000010010010010
10000000000010010000000
10000111111010010011111
10000000000010010000000
10000001000010010000000
10000111100010010000000
10000001000000010000000
10000000000000111111111
00000000000000000000000
01111111111111111111111
this is another map
