11111111111111111111111
10000000000000000000000
10000000000000000000000
10000000000000000000000
10000000000000000000000
10000000000000000000000
10000000000000000000000
10000000000010000000000
10000000000000000000000
10000000000000000000000
10000000000010000000000
10000000000000000000000
10000000000000000000000
10000000000000000000000
10000000000000000000000
10000000000000000000000
10000000000000000000000
10000000000000000000000
10000000000000000000000
10000000000000000000000
10000000000000000000000
10000000000000000000000
10000000000000000000000
11111111111111111111111
this is a map


111111111111111111111111111111111111111
100000000000000000000000000000000000000
100000000000000000000000000000000000000
100000000000000000000000000000000000000
100000000000000000000000000000000000000
100000000000000000000000000000000000000
100000000000000000000000000000000000000
100000000000000000000000000000000000000
100000000000000000000000000000000000000
100000000000000000000000000000000000000
100000000000000000000000000000000000000
100000000000000000000000000000000000000
100000000000000000000000000000000000000
100000000000000000011111000000000000000
100000000000000000000000000000000000000
100000000000000000000000000000000000000
100000000000000000000000000000000000000
100000000000000000000000000000000000000
100000000000000000000000000000000000000
100000000000000000000000000000000000000
100000000000000000000000000000000000000
100000000000000000000000000000000000000
100000000000000000000000000000000000000
100000000000000000000000000000000000000
100000000000000000000000000000000000000
100000000000000000000000000000000000000
100000000000000000000000000000000000000
100000000000000000000000000000000000000
100000000000000000000000000000000000000
100000000000000000000000000000000000000
100000000000000000000000000000000000000
100000000000000000000000000000000000000
100000000000000000000000000000000000000
100000000000000000000000000000000000000
100000000000000000000000000000000000000
100000000000000000000000000000000000000
100000000000000000000000000000000000000
100000000000000000000000000000000000000
100000000000000000000000000000000000000
111111111111111111111111111111111111111
ok 40x40



11111111
10000000
10000000
10000000
10000000
10000000
10000000
10000000
10000000
ok 9x9
